ACautoPartsNET: RT@nicolasfrankel Yet another #Volkswagen hack time #Spock Poor guys ) .negative
tfoxlaw: RT@nytimesbusiness Outrage Volkswagen announces repair plan .negative
saintjallen: RT@bonniecarleton Happy winter #SNRTG #Vanlife #wcamper #vwlove @vwcamperfan @vwcamper @volkswagen @vwcampervans @CamperSpotting .positive
IvanTumaJr: Real Winner #VWGate Diesel Scandal #Hybrid Cars #GreenAndInclusive via @WIRED .negative
ArunRChari: RT@skycinemas Leonardo DiCaprio producing movie Volkswagen Scandal ) WOW ) @LeoDiCaprio Waiting .neutral
rowenacheyne: RT@VIralBuzzNewss 2016 Volkswagen Beetle Denim puts favorite blues  .positive
BeingExample: RT@berlinfancy cares #ecology Burn ground Drive #Volkswagen D #VW #Diesel #CO2 #Emmission #Scanda .negative
Doug_Houghton: RT@irwinmitchell Read consumer law expert Lindsey Pedley say #VWScandal latest #Volkswagen .negative
island_on: yaoqianming RT BROWNSVWPEI Happy Thanksgiving everyone Volkswagen family yours ) #BROWNSVW #PEI # .positive
jewelsluv: RT@ForeignPolicy Volkswagen emissions scandal just made Made Germany 191 billion less valuable @davidcfrancis reports .negative
NorthWestDubs: RT@VWt6transporter Nice shot guys #VW friends #Volkswagen #Transporter Gallery seek submissions model year welcomed RT RT .positive
MichaelEwing1: RT@AnimalRightsJen #ClimateChange #CC Investors ask automakers explain emissions lobbying Reuters Leadi #U .negative
DjulovicD: months ago @managermagazin article #corruption #Volkswagen #China #VWGate #tech #startup .negative
zxc1n2345jk: RT@AdelAlmalki #news #almalki Volkswagen emissions scandal headed Hollywood .neutral
ozmoi: RT@engadget Volkswagens US head knew possible emissions trouble 2014 .negative
fandelat3: RT@bonniecarleton Happy winter #SNRTG #Vanlife #wcamper #vwlove @vwcamperfan @vwcamper @volkswagen @vwcampervans @CamperSpotting .positive
emekli56: RT@FRANCE24 Volkswagen scandal set movie produced DiCaprio .negative
Emily3763: RT@VWofAnnArbor know #Golf GTE Sport gullwinged plugin hybrid 395 horsepower .positive
YordLeos: RT@business US House panel wants details Volkswagen cheated emissions tests .neutral
yaoqianming: RT@BROWNSVWPEI Happy Thanksgiving everyone Volkswagen family yours ) #BROWNSVW #PEI #TurkeyDay #Thanksgiving .positive
wisewatch: RT@AnimalRightsJen #ClimateChange #CC Investors ask automakers explain emissions lobbying Reuters Leadi #U .negative
TheNestJR: RT@Imperialcar 185+ RAC Inspected #Volkswagen models available ������5845 ������117 per month* #MotorHappy #Ca��������� .positive
RosaMG721: RT@TelegraphNews Leonardo DiCaprio Paramount Pictures option book Volkswagen scandal .neutral
malinidas: RT@triketora Volkswagen detects tests run CI server makes pass .negative
rachieskeldon: RT@ictruckandvan Volkswagen Van Centre Stoke New VW Caddy & Transporter Launch Jessica Smith 2201 Events 6th .positive
YordLeos: RT@ReutersBiz #Volkswagen CEO says recall start January completed end2016 .negative
hitendra38: RT@shikhashrivas Always suspected Volkswagen alone  ( .positive
SprinklesBunnie: RT@stbusinessdesk Volkswagen emissions scandal set movie produced Leonardo DiCaprio .neutral
CPontoppidan: RT@auchenberg 1000+ GitHub stars  Volkswagen less 10 hours defeat device officially control D D .negative
skialturki: RT@CNBC Volkswagens Beetle goes rugged Dune .positive
usumtwit: Volkswagens US boss knew #emissions problems 2014 Volkswagen s top USbased .negative
hpaul89: goes bae #vw #volkswagen #blue #purple #whip #vine #dub .negative
brunoweis: RT@NYMag Leonardo DiCaprio producing movie Volkswagen scandal .neutral
Mayo360Wedding: #USAfricaBF Leak Britain says Volkswagen must meet costs retesting vehicles .negative
rolocekitoq: RT@CarAutoDaily 2016 Volkswagen Beetle Dune Bit Baja Bug  .positive
DubLuvTuning: RT@vwt4 one smart bus mate #Volkswagen #Transporter Gallery seek submissions model year RT RT .positive
LilliaPooser399: California gives #VolkswagenNovember 20 deadline technical fix diesel scandal .positive
amefuture: RT@ForeignPolicy Volkswagen emissions scandal just made Made Germany 191 billion less valuable @davidcfrancis reports .negative
ClimateWise2015: RT@AnimalRightsJen #ClimateChange #CC Investors ask automakers explain emissions lobbying Reuters Leadi #U .negative
BizNgayon: WORLD  Volkswagens US head knew possible emissions trouble 2014 .neutral
visualsandra: Wednesday Evening Briefing Russian Strikes Volkswagen Admissions  New York Times .negative
innovect: Volkswagen detects tests run CI server makes pass HILARIOUS .negative
titch_316: liked @YouTube video GTA 5 Volkswagen GTI Fahrenheit Chase .neutral
rachieskeldon: RT@VolkswagenCV Fancy driving latest #Volkswagen Commercial Vehicle want it Check Contract Hire Plan .positive
kevin_seth: RT@Volkswagen #iPhone6s one gorgeous display #PassatGTE actually two #AppleEvent #iPhone #Volkswagen .positive